1 2 1 2 1 2 1 2 1 2 1 2 1
2 2 2 2 2 2 2 2 2 2 2 2 2
2 1 3 1 5 1 5 1 5 1 3 1 2
2 3 3 5 5 5 5 5 5 5 3 3 2
2 1 3 1 5 1 5 1 5 1 3 1 2
2 2 3 3 5 5 5 5 5 3 3 2 2