1 1 1 1 1 1 1 1 1 1 1 1 1 1 1 	 
1 0 5 5 0 5 5 2 5 5 0 5 5 0 1 	 
1 5 5 5 5 5 5 5 5 5 5 5 5 5 1 	 
1 0 3 3 0 3 3 2 3 3 0 3 3 0 1 	 
1 3 3 3 2 3 3 3 3 2 3 3 3 3 1 	 
1 0 2 2 0 2 2 0 2 2 0 2 2 0 1 	 
1 2 2 2 2 2 2 2 2 2 2 2 2 2 1 	 
1 0 1 1 0 1 1 0 1 1 0 1 1 0 1 	